index.php:	Software testing is our core competence

company/request.php:	Online request 
company/contact.php:	Contact 
company/jobs.php:	Jobs
company/past_events.php:	Events
company/jobs/webapp.php:	Web Application Engineer 
company/jobs/test_manager.php:	Test Manager
company/jobs/finance.php:	Finance Test Consultant 
company/jobs/performance.php:	Performance Test Consultant 
company/jobs/assistent.php:	Test Automation Engineer 
company/jobs/telco.php:	Software Application Tester 
company/jobs/test_engineer.php:	Test Engineer
company/jobs/manual_tester.php:	Manual Tester
company/jobs/automation.php:	Test Automation Engineer 
company/news.php:	Jobs 
company/events.php:	Events
company/location.php:	Contact

contact/request.php:	Online request 
contact/index.php:	Contact 
contact/location.php:	Contact

courses/upcoming_courses.php:	Certified Tester - Upcoming Courses 
courses/course_structure.php:	Certified Tester - Course Structure 
courses/index.php:	Certified Tester 
courses/functional_tester.php:	Certified Tester - Functional Tester-ISTQB&#174;-Certified Tester Advanced Level 
courses/upcoming_courses_alt.php:	Certified Tester - Upcoming Courses 
courses/background_information.php:	Certified Tester - Background information 
courses/technical_tester.php:	Technical Tester-ISTQB&#174;-Certified Tester Advanced Level 
courses/test_manager.php:	Testmanager-ISTQB&#174;-Certified Tester Advanced Level
courses/more_information.php:	Please send me more information 
courses/foundation_level.php:	ISTQB&#174;-Certified Tester Foundation Level 
courses/sign_in.php:	Certified Tester - Registration 
courses/conditions.php:	AGBs Certified Tester 
customers/index.php:	Customers 

partners/index.php:	Partners
partners/consulting.php:	Partners 

portfolio/financial_application_testing.php:	Financial Application Testing
portfolio/test_engineering.php:	Test Engineering
portfolio/index.php:	Service Portfolio
portfolio/test_consultancy.php:	Test Consultancy
portfolio/test_case_and_tool_development.php:	Test Case and Tool Development 
portfolio/managed_testing_services.php:	Managed Testing Services
portfolio/test_automation.php:	Test Automation
portfolio/performance_testing.php:	Performance Testing
portfolio/more_information.php:	Please send me more information
portfolio/mobile_application_testing.php:	Mobile Application Testing
portfolio/software_test_outsourcing.php:	Software Test Outsourcing 

products/index.php:	Products &#38; Solutions 
products/sotograph.php:	Software Health Check 
products/more_information.php:	Please send me more information 
products/agitarone.php:	Products &#38; Solutions 

template/template.php:	 

trends_in_testing/agenda.php:	Trends in Testing 2012 - Referenten
trends_in_testing/partner.php:	Trends in Testing 2012 - Partner
trends_in_testing/index.php:	Agile Testing, Test nonstop, Softwaretest
trends_in_testing/speaker.php:	Trends in Testing 2012 - Partner
trends_in_testing/sign-in.php:	Trends in Testing 2012 - Anmeldung
trends_in_testing/schedule.php:	Trends in Testing 2012 - Referenten
trends_in_testing/experts.php:	Trends in Testing 2012 - Meet the experts

impressum.php:	Software testing is our core competence
